1111111111111111111111111111111111111111111
1GP00000G0000000000C1C0000001000G0000000001
11110010100100011111111111101010G0G0G0010C1
10001010101100000000000000001010G0G0G011111
11101010100111111111111111101010G0G0G001001
100010101000100010100000C0001C1000G0G000001
101010101011101C00100111111111111110G001001
10101010100C1101000000000000000000000001001
101010101G11100101110101001C111111100111001
101C10101000110100C111111111C0000000000C001
1010001010101001000100C10000000001111000101
11C11G1010101110011101110111011110100010101
1C00001010101000G01000000000000010101110101
1111101010101010000010111111111110100010101
1000001000101011111010000000000000100010101
1011101G101010100010101111101111001111101C1
1010100000G01010010010010100100000100010111
10101010101010101C1010010000100000100010001
1010101011101010101010010111111110010000001
10101010010010001011101101001C00111111000G1
1C1000101000000C10000001C01010000000000G0E1
1111111111111111111111111111111111111111111