1111111111111111111111111111111111111111111
1P00000010000000000C1C000000100010000000001
11110010100100011111111111101010101010010C1
1000101010110000000000000000101010101011111
1110101010011111111111111110101010101001001
100010101000100010100000C0001C1000101000001
101010101011101C001001111111111111101001001
10101010100C1101000000000000000000000001001
101010101111100101110101001C111111100111001
101C10101000110100C111111111C0000000000C001
1010001010101001000100C10000000001111000101
11C1111010101110011101110111011110100010101
1000001010101000G01000000000000010101110101
1111101010101010000010111111111110100010101
1000001000101011111010000000000000100010101
10111011101010100010101111101111001111101C1
1010100000101010010010010100100000100010111
10101010101010101C1010010000100000100010001
1010101011101010101010010111111110010000001
10101010010010001011101101001C0011111110001
1C1000101000000C10000001C0101000000000000E1
1111111111111111111111111111111111111111111