1111111111111111111111
10EC00000000000000C001
11111111111C11C1111001
100C0000000000C0000001
1001001101001110C00001
1001000101001C10000101
1001010101C00010C00101
1000010100000111000101
1001010101100010000101
1C00C1P1C11C000000C1C1
1111111111111111111111